[
  [ 20 ,3 ,3 ,3 ,3 ,3 ,3 ,3 ,3 ,3 ,3 ,3 ,3 ,3 ,3 ,3 ,3 ,3,20,20,20,20,20,20,20,20,20,20,20,20,20,20,20,20,20],
  [ 3 ,3 ,4 ,4 ,4 ,4 ,4 ,4 ,4 ,4 ,4 ,4 ,4 ,4 ,4 ,4 ,4 ,3 ,3 ,3 ,3 ,3 ,3 ,3 ,3,20,20,20,20,20,20,20,20,20,20],
  [ 3 ,4 ,4 ,1 ,4 ,4 ,4 ,1 ,1 ,1 ,1 ,1 ,4 ,4 ,4 ,1 ,4 ,4 ,4 ,4 ,4 ,4 ,4 ,4 ,3 ,3 ,3,20,20,20,20,20,20,20,20],
  [ 3 ,4 ,1 ,1 ,1 ,4 ,4 ,4 ,1 ,3 ,1 ,4 ,4 ,4 ,1 ,1 ,1 ,4 ,3 ,3 ,3 ,3 ,3 ,4 ,4 ,4 ,3 ,3 ,3 ,3 ,3,20,20,20,20],
  [ 3 ,4 ,4 ,1 ,4 ,4 ,3 ,4 ,4 ,1 ,4 ,4 ,3 ,4 ,4 ,1 ,4 ,4 ,3 ,3 ,3 ,3 ,3 ,3 ,3 ,4 ,4 ,4 ,4 ,4 ,3 ,3 ,3 ,3 ,3],
  [ 3 ,1 ,4 ,4 ,4 ,3 ,3 ,3 ,4 ,4 ,4 ,3 ,3 ,3 ,4 ,4 ,4 ,1 ,3 ,3 ,3 ,3 ,3 ,3 ,3 ,4 ,1 ,1 ,1 ,4 ,5 ,5 ,5 ,7 ,3],
  [ 3 ,4 ,4 ,1 ,4 ,4 ,3 ,4 ,4 ,1 ,4 ,4 ,3 ,4 ,4 ,1 ,4 ,4 ,3 ,3 ,3 ,3 ,3 ,3 ,3 ,4 ,4 ,4 ,4 ,4 ,3 ,3 ,3,6 ,3],
  [ 3 ,4 ,1 ,1 ,1 ,4 ,4 ,4 ,1 ,3 ,1 ,4 ,4 ,4 ,1 ,1 ,1 ,4 ,3 ,3 ,3 ,3 ,3 ,4 ,4 ,4 ,3 ,3 ,3 ,3 ,3,20 ,3,6 ,3],
  [ 3 ,4 ,4 ,1 ,4 ,4 ,4 ,1 ,1 ,1 ,1 ,1 ,4 ,4 ,4 ,1 ,4 ,4 ,4 ,4 ,4 ,4 ,4 ,4 ,3 ,3 ,3,20,20,20,20,20 ,3 ,4 ,3],
  [ 3 ,3 ,4 ,4 ,4 ,4 ,4 ,4 ,4 ,4 ,4 ,4 ,4 ,4 ,4 ,4 ,4 ,3 ,3 ,3 ,3 ,3 ,3 ,3 ,3,20,20,20,20,20,20,20 ,3 ,4 ,3],
  [ 20 ,3 ,3 ,3 ,3 ,3 ,3 ,3 ,3 ,3 ,3 ,3 ,3 ,3 ,3 ,3 ,3 ,3,20,20,20,20,20,20,20,20,20,20,20,20,20,20 ,3 ,4 ,3],
  [ 20,20,20,20,20,20,20,20,20,20,20,20,20,20,20,20,20,20,20 ,3 ,3 ,3 ,3 ,3,20,20 ,3 ,3 ,3 ,3 ,3 ,3 ,3 ,4 ,3],
  [ 20,20 ,3 ,3 ,3 ,3 ,3 ,3 ,3 ,3 ,3 ,3 ,3 ,3 ,3 ,3,20,20,20 ,3 ,3 ,9 ,3 ,3,20,20 ,3 ,4 ,4 ,4 ,4 ,4 ,4 ,4 ,3],
  [ 20,20 ,3 ,4 ,3 ,4 ,1 ,4 ,4 ,4 ,1 ,4 ,4 ,4 ,1 ,3,20,20,20 ,3 ,8 ,10 ,8 ,3,20,20 ,3 ,4 ,1 ,4 ,1 ,4 ,1 ,4 ,3],
  [ 20,20 ,3 ,4 ,3 ,4 ,1 ,4 ,1 ,4 ,1 ,4 ,1 ,4 ,1 ,3,20,20,20 ,3 ,8 ,8 ,8 ,3,20,20 ,3 ,4 ,1 ,4 ,1 ,4 ,1 ,4 ,3],
  [ 20,20 ,3 ,4 ,4 ,4 ,4 ,4 ,1 ,4 ,4 ,4 ,1 ,4 ,0 ,3,20,20,20 ,3 ,1 ,8 ,1 ,3,20,20 ,3 ,4 ,4 ,4 ,4 ,4 ,4 ,4 ,3],
  [ 20,20 ,3 ,4 ,3 ,4 ,1 ,4 ,1 ,4 ,1 ,4 ,1 ,4 ,1 ,3,20,20,20 ,3 ,8 ,8 ,8 ,3,20,20 ,3 ,3 ,3 ,3,6 ,3 ,3 ,3 ,3],
  [ 20,20 ,3 ,4 ,3 ,4 ,1 ,4 ,4 ,4 ,1 ,4 ,4 ,4 ,1 ,3,20,20,20 ,3 ,1 ,8 ,1 ,3,20,20,20,20,20 ,3,6 ,3,20,20,20],
  [ 20,20 ,3 ,4 ,3 ,3 ,3 ,3 ,3 ,3 ,3 ,3 ,3 ,3 ,3 ,3,20,20,20 ,3 ,3 ,4 ,3 ,3 ,3 ,3 ,3 ,3 ,3 ,3 ,4 ,3 ,3 ,3 ,3],
  [ 20,20 ,3 ,4 ,4 ,4 ,4 ,3,20,20,20,20,20,20,20,20,20,20,20 ,3 ,3 ,4 ,3 ,3 ,4 ,1 ,1 ,4 ,1 ,1 ,4 ,1 ,1 ,4 ,3],
  [ 20,20 ,3 ,4 ,1 ,1 ,4 ,3,20 ,3 ,3 ,3 ,3 ,3 ,3 ,3 ,3 ,3,20 ,3 ,4 ,4 ,4 ,4 ,4 ,4 ,4 ,4 ,4 ,4 ,4 ,4 ,4 ,4 ,3],
  [ 20,20 ,3 ,4 ,4 ,4 ,4 ,3,20 ,3 ,4 ,4 ,4 ,4 ,4 ,4 ,4 ,3,20 ,3 ,1 ,4 ,3 ,3 ,3 ,3 ,1 ,4 ,3 ,3 ,3 ,3 ,4 ,1 ,3],
  [ 20,20 ,3 ,4 ,1 ,1 ,4 ,3,20 ,3 ,4 ,1 ,1 ,4 ,1 ,1 ,4 ,3,20 ,3 ,4 ,4 ,3 ,3 ,3 ,1 ,1 ,4 ,3 ,3 ,3 ,3 ,4 ,4 ,3],
  [ 20,20 ,3 ,4 ,4 ,4 ,4 ,3,20 ,3 ,4 ,4 ,4 ,4 ,4 ,4 ,4 ,3,20 ,3 ,4 ,1 ,3 ,3 ,3 ,3 ,4 ,4 ,3 ,3 ,3 ,3 ,1 ,4 ,3],
  [ 20,20 ,3 ,4 ,1 ,1 ,4 ,3,20 ,3 ,3 ,3 ,3 ,4 ,3 ,3 ,3 ,3,20 ,3 ,4 ,4 ,3 ,3 ,3 ,3 ,4 ,1 ,1 ,3 ,3 ,3 ,4 ,4 ,3],
  [ 20,20 ,3 ,4 ,4 ,4 ,4 ,3,20,20,20,20 ,3 ,4 ,3,20,20,20,20 ,3 ,1 ,4 ,3 ,3 ,3 ,3 ,4 ,1 ,3 ,3 ,3 ,3 ,4 ,1 ,3],
  [ 20,20 ,3 ,4 ,1 ,1 ,4 ,3 ,3 ,3 ,3 ,3 ,3 ,4 ,3 ,3 ,3 ,3 ,3 ,3 ,4 ,4 ,4 ,4 ,4 ,4 ,4 ,4 ,4 ,4 ,4 ,4 ,4 ,4 ,3],
  [ 20,20 ,3 ,4 ,4 ,4 ,4 ,4 ,4 ,4 ,4 ,4 ,4 ,4 ,4 ,4 ,4 ,4 ,4 ,4 ,4 ,1 ,1 ,4 ,1 ,1 ,4 ,1 ,1 ,4 ,1 ,1 ,4 ,3 ,3],
  [ 20,20 ,3 ,3 ,3 ,3 ,3 ,3 ,3 ,3 ,3 ,3 ,3 ,3 ,3 ,3 ,3 ,3 ,3 ,3 ,3 ,3 ,3 ,3 ,3 ,3 ,3 ,3 ,3 ,3 ,3 ,3 ,3 ,3,20]
]
