[
  [ 24 , 3 , 3 , 3 , 3 , 3 , 3 , 3 , 3 , 3 , 3 , 3 , 3 , 3 , 3 , 3 , 3 , 3 , 3, 24],
  [ 3 , 3 , 4 , 4 , 4 , 4 , 4 , 4 , 4 , 4 , 4 , 4 , 4 , 4 , 4 , 4 , 4 , 4 , 3 , 3],
  [ 3 , 4 , 4 , 1 , 4 , 1 , 4 , 1 , 4 , 1 , 1 , 4 , 1 , 4 , 1 , 4 , 1 , 4 , 4 , 3],
  [ 3 , 1 , 4 , 4 , 4 , 1 , 1 , 1 , 4 , 4 , 4 , 4 , 1 , 1 , 1 , 4 , 4 , 4 , 1 , 3],
  [ 3 , 4 , 4 , 1 , 4 , 4 , 4 , 4 , 4 , 1 , 1 , 4 , 4 , 4 , 4 , 4 , 1 , 4 , 4 , 3],
  [ 3 , 4 , 1 , 1 , 1 , 4 , 1 , 4 , 4 , 4 , 4 , 4 , 4 , 1 , 4 , 1 , 1 , 1 , 4 , 3],
  [ 3 , 4 , 4 , 1 , 4 , 4 , 4 , 4 , 3 , 3 , 3 , 3 , 4 , 4 , 4 , 4 , 1 , 4 , 4 , 3],
  [ 3 , 3 , 25 , 25 , 4 , 3 , 3 , 3 , 3, 24, 24 , 3 , 3 , 3 , 3 , 4 , 4 , 4 , 3 , 3],
  [ 24 , 3 , 3 ,6 , 3 , 3, 24, 24, 24, 24, 24, 24, 24, 24 , 3 , 3 ,6 , 3 , 3, 24],
  [ 24, 24 , 3 ,6 , 3, 24, 24, 24, 24, 24, 24, 24, 24, 24, 24 , 3 ,6 , 3, 24, 24],
  [ 24 , 3 , 3 ,6 , 3 , 3, 24, 24, 24, 24, 24, 24, 24, 24 , 3 , 3 ,6 , 3 , 3, 24],
  [ 3 , 3 , 4 , 4 , 4 , 3 , 3 , 3 , 3, 24, 24 , 3 , 3 , 3 , 3 , 4 , 4 , 4 , 3 , 3],
  [ 3 , 4 , 4 , 1 , 4 , 4 , 4 , 4 , 3 , 3 , 3 , 3 , 4 , 4 , 4 , 4 , 1 , 4 , 4 , 3],
  [ 3 , 4 , 1 , 1 , 1 , 4 , 1 , 4 , 4 , 4 , 4 , 4 , 4 , 1 , 4 , 1 , 1 , 1 , 4 , 3],
  [ 3 , 4 , 4 , 1 , 4 , 4 , 4 , 4 , 4 , 1 , 1 , 4 , 4 , 4 , 4 , 4 , 1 , 4 , 4 , 3],
  [ 3 , 1 , 4 , 4 , 4 , 1 , 1 , 1 , 4 , 4 , 4 , 4 , 1 , 1 , 1 , 4 , 4 , 4 , 1 , 3],
  [ 3 , 4 , 4 , 1 , 4 , 1 , 4 , 1 , 4 , 1 , 1 , 4 , 1 ,0 , 1 , 4 , 1 , 4 , 4 , 3],
  [ 3 , 3 , 4 , 4 , 4 , 4 , 4 , 4 , 4 , 4 , 4 , 4 , 4 , 4 , 4 , 4 , 4 , 4 , 3 , 3],
  [ 24 , 3 , 3 , 3 , 3 , 3 , 3 , 3 , 3 , 3 , 3 , 3 , 3 , 3 , 3 , 3 , 3 , 3 , 3, 24]
]
