[
[ 20 , 3 , 3 , 3 , 3 , 3 , 3 , 3 , 3 , 3 , 3 , 3 , 3 , 3 , 3 , 3 , 3 , 3 , 3, 20],
[ 3 , 3 , 4 , 4 , 4 , 4 , 4 , 4 , 4 , 4 , 4 , 4 , 4 , 4 , 4 , 4 , 4 , 4 , 3 , 3],
[ 3 , 4 , 4 , 1 , 4 , 1 , 4 , 1 , 4 , 1 , 1 , 4 , 1 , 4 , 1 , 4 , 1 , 4 , 4 , 3],
[ 3 , 4 , 1 , 1 , 4 , 1 , 1 , 1 , 4 , 4 , 4 , 4 , 1 , 1 , 1 , 4 , 1 , 1 , 4 , 3],
[ 3 , 4 , 4 , 4 , 4 , 4 , 4 , 4 , 4 , 1 , 1 , 4 , 4 , 4 , 4 , 4 , 4 , 4 , 4 , 3],
[ 3 , 4 , 1 , 1 , 1 , 4 , 1 , 1 , 4 , 4 , 4 , 4 , 1 , 1 , 4 , 1 , 1 , 1 , 4 , 3],
[ 3 , 4 , 4 , 1 , 4 , 4 , 1 , 1 , 1 , 1 , 1 , 1 , 1 , 1 , 4 , 4 , 1 , 4 , 4 , 3],
[ 3 , 3 , 4 , 4 , 1 , 4 , 1 , 4 , 4 , 4 , 4 , 4 , 4 , 1 , 4 , 1 , 4 , 4 , 3 , 3],
[ 20 , 3 , 3 , 4 , 4 , 4 , 4 , 4 , 3 , 3 , 3 , 3 , 4 , 4 , 4 , 4 , 4 , 3 , 3, 20],
[ 20, 20 , 3 , 4 , 1 , 1 , 4 , 1 , 3, 20, 20 , 3 , 1 , 4 , 1 , 1 , 4 , 3, 20, 20],
[ 20 , 3 , 3 , 4 , 4 , 4 , 4 , 4 , 3 , 3 , 3 , 3 , 4 , 4 , 4 , 4 , 4 , 3 , 3, 20],
[ 3 , 3 , 4 , 4 , 1 , 4 , 1 , 4 , 4 , 4 , 4 , 4 , 4 , 1 , 4 , 1 , 4 , 4 , 3 , 3],
[ 3 , 4 , 4 , 1 , 4 , 4 , 1 , 1 , 1 , 1 , 1 , 1 , 1 , 1 , 4 , 4 , 1 , 4 , 4 , 3],
[ 3 , 4 , 1 , 1 , 1 , 4 , 1 , 1 , 4 , 4 , 4 , 4 , 1 , 1 , 4 , 1 , 1 , 1 , 4 , 3],
[ 3 , 4 , 4 , 4 , 4 , 4 , 4 , 4 , 4 , 1 , 1 , 4 , 4 , 4 , 4 , 4 , 4 , 4 , 4 , 3],
[ 3 , 4 , 1 , 1 , 4 , 1 , 1 , 1 , 4 , 4 , 4 , 4 , 1 , 1 , 1 , 4 , 1 , 1 , 4 , 3],
[ 3 , 4 , 4 , 1 , 4 , 1 , 4 , 1 , 4 , 1 , 1 , 4 , 1 , 0 , 1 , 4 , 1 , 4 , 4 , 3],
[ 3 , 3 , 4 , 4 , 4 , 4 , 4 , 4 , 4 , 4 , 4 , 4 , 4 , 4 , 4 , 4 , 4 , 4 , 3 , 3],
[ 20 , 3 , 3 , 3 , 3 , 3 , 3 , 3 , 3 , 3 , 3 , 3 , 3 , 3 , 3 , 3 , 3 , 3 , 3, 20]
]
